.....................................
.....................................
.....................................
.....................................
.....................................
.....................................
.....................................
.....................................
.....................................
.....................................
.....................................
.....................................
.....................................
.........###.........................
.....................................
.....................................
....###.......###....................
.....................................
.A......!....O....Z..................
###################################..