.........................................................................................................................................................................................................................................................
.........................................................................................................................................................................................................................................................
.........................................................................................................................................................................................................................................................
.........................................................................................................................................................................................................................................................
................................................................................................................................PP.......................................................................................................................
...............................................................................................................................VPP.......................................................................................................................
.............................................................................................................................LSSSSR......................................................................................................................
...........................................................................................................................P.....P.....PPPP.....P.....PPP................................................................................................
....................................PP...................................................................................................................................................................................................................
..........................................................................................................................LSR...LSR...LSSSSR...LSR...LSSSSR..............................................................................................
....................................LR..........PP.......................................................................................................................................................................................................
.......................................................................................................................LSR.................................LSSR..........................................................................................
.............................PP...........LSSR..............................................PP...........................................................................................................................................................
............................LSSR.................LSSR.....PP..............................................................LSR.....................................TTTSSR......TTT........................................................................
.............P.....................LSSR...................................................TTTTTT..................................................................MMM.........MMMTTT.....................PPPP............................................
............LSR........TTT................LSR...........TTT.........................LSR...MMMMMM.......................LSR...LSSTTT...PP..PP..PP............LSR...MMM......LRRMMMMMM...................LSSSSSSR..........................................
......................PMMM...............PP.............MMM..........PPPP...............P.MMMMMMTT....................PPP.....P.MMM...............................MMM....PP...MMMMMMTTT..................................................................
..I.................TTTMMM...............PPV............MMMTTT........VV........TTTT......MMMMMMMMTT...................V......P.MMM............................TTTMMM.V..PP...MMMMMMMMM.............V...............................................F....
TTTTTTTTTTTTTTTTTTTTMMMMMMTTTTTTTTTTTTTTTTTTTTTTTTTTTTTTMMMMMMTTTTTTTTTTTTTTTTTTMMMMTTTTTTMMMMMMMMMMTTTTTTTTTTTTTTTTTTTTTTTTTTTTMMMTTTTTTTTTTTTTTTTTTTTTTTTTTTTMMMMMMTTTTTTTTTMMMMMMMMMTTTTTTTTTTTTTTTTTTTTTTTTTTTTTTTTTTTTTTTTTTTTTTTTTTTTTTTTTTTTTTTTTT
MMMMMMMMMMMMMMMMMMMMMMMMMMMMMMMMMMMMMMMMMMMMMMMMMMMMMMMMMMMMMMMMMMMMMMMMMMMMMMMMMMMMMMMMMMMMMMMMMMMMMMMMMMMMMMMMMMMMMMMMMMMMMMMMMMMMMMMMMMMMMMMMMMMMMMMMMMMMMMMMMMMMMMMMMMMMMMMMMMMMMMMMMMMMMMMMMMMMMMMMMMMMMMMMMMMMMMMMMMMMMMMMMMMMMMMMMMMMMMMMMMMMMMMMM