....................
....................
..........Z.........
.......######.......
..O..............O..
####..O.O.O.O....###
.......O.O.O!O......
......########......
...##...........##..
....................
.O.O............O.O.
####............####
....................
.A..................
####################