....................
....................
....................
....................
....................
....................
....................
...........Z........
..........##........
........O...........
......##............
....O...............
...##...............
.A.....O............
####################