....................................................................................................................................................................................................................................................
....................................................................................................................................................................................................................................................
......................................................................................................................................WW............................................................................................................
....................................................................................................................................................................................................................................................
.....................................................................................................................................LSSR...........................................................................................................
...............................................................................................................................V...............VV...................................................................................................
...........................................................................................................................LSSSSR...LSSSSR...LSSSSR..........W......................................................................................
.............................................W...............................................................................................................W......................................................................................
...................................................W.....................................W..W...................W....LSR.........LSSSSTTSSSSR.........LSR...........................................................................................
............................................LSR..........W............................................................................MM....................LSR.....................................................................................
.................................W....TTT.........LSR..........W.....W...................T..T.............W....LSR....................MM............................................................................................................
.................................W..V.MMM...............LSR..........W...................M..M.........................................MM..............LSR...........................................................................................
................................TTTTTTMMM..........V..........LSR.........LSR.......LR....WW....LR.......TTT...............WWW......................................................................................................................
..................................................LSR...............TTT...............LR...V..LR.........MMM..V........................................W....LSR......................WW.............................................................
....................................................................MMM.................LSSSSR...........MMMSSSSSR.......LSSSSSR....................................................................................................................
.......................LSSSSR...............LSR...WW..............W.MMMSSR...............................MMM......................WWW.MM..............LSR.......................LSSSSSSSSSSR........................................................
.................TTT.....WW.....TTTSSR............................W.MMM...W............WWWWW....................................W.....MM............................................................................................................
..I..............MMM.....VV.WW..MMM...............VV...........V....MMM.VVW.............VVV.................WWWWW...............W.V..MMMM..................V........WW..WW......V..............................................................F....
TTTTTTTTTTTTTTTTTMMMTTTTTTTTTTTTMMMTTTTTTTTTTTTTTTTTTTTTTTTTTTTTTTTTMMMTTTTTTTTTTTTTTTTTTTTTTTTTTTTTTTTTTTTTTTTTTTTTTTTTTTTTTTTTTTTTTMMMMTTTTTTTTTTTTTTTTTTTTTTTTTTTTTTTTTTTTTTTTTTTTTTTTTTTTTTTTTTTTTTTTTTTTTTTTTTTTTTTTTTTTTTTTTTTTTTTTTTTTTTTTTTT
MMMMMMMMMMMMMMMMMMMMMMMMMMMMMMMMMMMMMMMMMMMMMMMMMMMMMMMMMMMMMMMMMMMMMMMMMMMMMMMMMMMMMMMMMMMMMMMMMMMMMMMMMMMMMMMMMMMMMMMMMMMMMMMMMMMMMMMMMMMMMMMMMMMMMMMMMMMMMMMMMMMMMMMMMMMMMMMMMMMMMMMMMMMMMMMMMMMMMMMMMMMMMMMMMMMMMMMMMMMMMMMMMMMMMMMMMMMMMMMMMMMM