....................................................................................................................................................................................................................................................
....................................................................................................................................................................................................................................................
....................................................................................................................................................................................................................................................
.................................................................................................GG..................................................GG..........VV.................................................................................
...............................................................................................LSSSSR......LSSSSR..................................LSSSSR......LSSSSR...............................................................................
.....................................................................................................................................................VV.............................................................................................
...............................................................................................LSSSSR..GG..LSSSSR..................................LSSSSR......LSSSSR...............................................................................
.......................................................................GGGG............................VV..........VVV......GGG.......................................................GG............................................................
.................................................VVVGGG................GVVV.......TTTTTTTTTTTTTSSSSSSSSSSSSSSSSSSSSSSSSSSSSSSSSSSSSSR.......LSSSSSSSSSSSSSSSSSSSSSSSSSSSSSSSSSSSSSSSSSSSSSR.........................................................
..........................................TTTTTTTTTTTTTTTTTTTTTTTTTTSSSSSSSSSSSSSSMMMMMMMMMMMMM.....................................................................................................................................................
..............................V....V.GG.V.MMMMMMMMMMMMMMMMMMMMMMMMMM...................................................................TTT....................G.V.........V.G..............LSSSSR...................................................
.........................TTSSSSSSSSSSSSSSSMMMMMMMMMMMMMMMMMMMMMMMMMM...............VV..................................................MMM....................LSSSR.....LSSSR......................VV...............................................
......................TTTMM......................................................LSSSSR.............................................TTTMMMTTT.G......................G...........................LSSSSR.............................................
......................MMMMM................GG..........GG..........................................G........................V.......MMMMMMMMMTTT.....................V....................................G.........................................
...................TTTMM...................VV........LSSSSR.......VV.......LSSSSR..................G..........LSSSSSR......TTTT..............MMMVV.......LSSSR.....LSSSR.....LSSSR.....................LSSSSR.......................................
...................MMMMM.................LSSSSR.................LSSSSR................G..LSR.......G.VV..................GGMMMM..............MMMTTTTTT...............................TTTT...........................................................
................TTTMMG................G............................................G.............TTTSSSSSSR.............TTTMMMMTTTGG........GMMMMMMMMM...............................MMMM....................LSSSSR............................F....
..I.............MMMMMG.VV.............GVV...........................................VVV..........MMM.VV..GG.............MMMMMMMMMMTTT...VV..GMMMMMMMMMTTT......V.GG..V.GG.V.......TTTMMMMTTT.......................VV...............................
TTTTTTTTTTTTTTTTMMMMMTTTTTTTTTTTTTTTTTTTTTTTTTTTTTTTTTTTTTTTTTTTTTTTTTTTTTTTTTTTTTTTTTTTTTTTTTTTTMMMTTTTTTTTTTTTTTTTTTTTMMMMMMMMMMMMMTTTTTTTTMMMMMMMMMMMMTTTTTTTTTTTTTTTTTTTTTTTTTMMMMMMMMMMTTTTTTTTTTTTTTTTTTTTTTTTTTTTTTTTTTTTTTTTTTTTTTTTTTTTTTTT
MMMMMMMMMMMMMMMMMMMMMMMMMMMMMMMMMMMMMMMMMMMMMMMMMMMMMMMMMMMMMMMMMMMMMMMMMMMMMMMMMMMMMMMMMMMMMMMMMMMMMMMMMMMMMMMMMMMMMMMMMMMMMMMMMMMMMMMMMMMMMMMMMMMMMMMMMMMMMMMMMMMMMMMMMMMMMMMMMMMMMMMMMMMMMMMMMMMMMMMMMMMMMMMMMMMMMMMMMMMMMMMMMMMMMMMMMMMMMMMMMMMM